###############
#@    C % C % #
###  ## #  C  #
##   #  ##  ###
#   %   ### ###
# CC  C  C  C #
#  C CCC # # C#
# CC C   # & C#
#  C C  #  # C#
#######X#######