###############
#@   C  %  #  #
## # ## ## ## #
#  %  C  #  X #
#   ###### ## #
# &  # C   #  #
#   # % # ##  #
#   #  ##     #
#      C   ####
###############